aaaaaaaaaaaaaaa
a...a.....a...a
a.a...aaa...a.a
a.a.a.....a.a.a
a...a.a.a.a...a
a.a.a.a.a.a.a.a
a.a...a.a...a.a
a.a.a.a.a.a.a.a
a...a.a.a.a...a
a.a.a.....a.a.a
a.a...aaa...a.a
a...a.....a...a
aaaaaaaaaaaaaaa