mmmmmmmmmmmmmmm
ms..m..m..m..sm
m.m...mmm...m.m
m.m.m.....m.m.m
m...m.m.m.m...m
m.m.m.m.m.m.m.m
m.m...m.m...m.m
m.m.m.m.m.m.m.m
m...m.m.m.m...m
m.m.m.....m.m.m
m.m...mmm...m.m
ms..m.....m..sm
m.m.m..m..m.m.m
m.m.m..m..m.m.m
mmmmmmmmmmmmmmm
